NO ./assets/textures/no1.xpm
SO ./assets/textures/so1.xpm
WE ./assets/textures/we1.xpm
EA ./assets/textures/ea1.xpm

F 220,100,0
C 225,30,024           


11111111111
10000000001
1011000001
100100W0011111111
111110000000000001
100000111111111111
1111111











