NO ./assets/textures/no1.xpm
SO ./assets/textures/so1.xpm
WE ./assets/textures/we1.xpm
EA ./assets/textures/ea1.xpm

F 220,100,0
C 225,30,0

11111111111
10000000001
10110000001
100100W0111
11111000001
10000011111
11111111111











