NO ./assets/textures/no1.xpm
SO ./assets/textures/so1.xpm
WE ./assets/textures/we1.xpm
EA ./assets/textures/ea1.xpm

F 220,100,0
C 225,30,0


111111111111111
100000000000001
100001000000001
100000000001001
1001000W0000001
100000000000001
111111111111111