NO ./assets/textures/no1.xpm
SO ./assets/textures/so1.xpm
WE ./assets/textures/we1.xpm
EA ./assets/textures/ea1.xpm


F 65,142,79
C 65,109,182

111111111111111111111111111111
1000000000000N0000000000000111
100000000000000000000000000111
101100000000000000011110000001
100100000000011111111111000001
111110000000000000000000000001
100000110000000000000000000001
111111111111111111111111111111










