NO ./assets/textures/no1.xpm
SO ./assets/textures/so1.xpm
WE ./assets/textures/we1.xpm
EA ./assets/textures/ea1.xpm

F 220,100,0
C 225,30,0


1111111111111111
1000000000001001
1000000001001001
1111000001001001
1000000W11111001
1000000000000001
1111100001111001
1000000000000001
1111111111111111