NO ./assets/textures/no1.xpm
SO ./assets/textures/so1.xpm
WE ./assets/textures/we1.xpm
EA ./assets/textures/ea1.xpm           

F 65,142,79
C 65,109,182

        1111111111111111111111111
        1000000000110000000000001
        1011000001110000000000001
        1001000000000000000000001
111111111011000001110000000000001
10000000001100000111011111101111
11110111111111011100000010001
11110111111111011101010010001
11000000110101011100000010001
10S00000000000001100000010001
10000000000000001101010010001
1100000111010101111101111000111
11110111 1110101 101111010001
11111111 1111111 111111111111