NO ./assets/textures/no1.xpm
SO ./assets/textures/so1.xpm
WE ./assets/textures/we1.xpm
EA ./assets/textures/ea1.xpm

F 65,142,79
C 65,109,182

11111111111
100N00000001
111111111111










