NO ./assets/textures/no1.xpm
SO ./assets/textures/so1.xpm
WE ./assets/textures/we1.xpm
EA ./assets/textures/ea1.xpm           

F 65,142,79
C 65,109,182

        11111111111111111111111  11111111111111111111111  11111111111111111111111  11111111111111111111111  1111111111
        10000000001100000000001  10000000001100000000001  10000000001100000000001  10000000001100000000011  1000000001
        10110000011100000000001  10110000011100000000001  10110000011100000000001  10110000011100000000011  1011000001
        10010000000000000000001  10010000000000000000001  10010000000000000000001  10010000000000000000011  1001000001
1111111110110000011100000000000111011000001110000000000011101100000111000000000001110110000011100000000000111011000001
1000000000110000011101111110111000011000001110111111011100001100000111011111101110000110000011101111110111000011000001
1111011111111101110000001000111111111011100000010001111111110111000000100011111111101110000001000111111111011100000011
1111011111111101110101001000111111111011101010010001111111110111010100100011111111101110101001000111111111011101010011
1100000011010101110000001000100110101011100000010001001101010111000000100010011010101110000001000100110101011100000011
10S0000000000000110000001000100000000001100000010001000000000011000000100010000000000110000001000100000000001100000011
1000000000000000110101001000100000000001101010010001000000000011010100100010000000000110101001000100000000001101010011
1100000111111010111110111100011101110101011111011110001110111010101111101111000111011101010111110111100011101110101011
1111111111111111111111111111111111111111111111111111111111111111111111111111111111111111111111111111111111111111111111
1111111111111111111111
1000000111111000000001
101100000111000000001
100100000000000000001
101100000111000000001
101100000111011111101
111111011100000010001
111111011101010010001
110101011100000010001
100000001100000010001
100000001101010010001
110101011 111011110001
111101011 101111010001
111111111 111111111111
100000001 111000000001
101100001 111000000001
100100001 100000000001
101100001 111000000001
101100001 111011111101
111111011 100000010001
111111011 101010010001
110101011 100000010001
100000001 100000010001
100000001 101010010001
110101011 111011110001
111101011 101111010001
111111111 111111111111
100000001 111000000001
101100000111000000001
100100000000000000001
101100000111000000001
101100000111011111101
111111011100000010001
111111011101010010001
110101011100000010001
100000001100000010001
100000001101010010001
110101011111011110001
11110101 101111010001
11111111 111111111111